0,0,1,1
0,6,4,3
4,5,7,4
11,6,1,2
12,7,2,2
14,6,1,3
11,1,2,3
14,0,1,3